11111111111111111
10100011000111111
11000110111001111
10110000111100111
11101111011011001
11101001011111111
10011011101001011
10111100111111111
10011011011111011
11100011011000001
10011111000111101
10100111110111101
11111111111111111